NO ./a.xpm
SO ./a.xpm
F 220,100,0


WE ./a.xpm
EA ./a.xpm




C 225,30,0


111111
100101
101001
1100N1
111111