NO ./textures/wall05.png
SO ./textures/wall06.png
F 71,168,61


WE ./textures/wall01.png
EA ./textures/wall01.png




C 149,205,245

11111
11011
10001
100111111111111
10001
11001
10001
10011
10001
11001
10001
10N01
11011
11111