
NO ./textures/wall05.png
SO ./textures/wall04.png
F 71,168,61


WE ./textures/wall01.png
EA ./textures/wall08.png




C 149,205,245

11111
11011
100011111111
100111111111111
10001
11001
10001
10011
10001
110011
100001
10N01
11111
11111