NO ./textures/north.xpm
SO ./textures/south.xpm
WE ./textures/west.xpm
EA ./textures/east.xpm
F 50,50,50
C 150,150,150

11111111111111111111
1N0000000000000000001
100011100000011100001
100000000000000000001
100011100000011100001
100000000000000000001
100011111111111100001
100000000000000000001
100000011111000000001
100000000000000000001
100000011111000000001
100000000000000000001
100011111111111100001
100000000000000000001
100011100000011100001
100000000000000000001
100011100000011100001
100000000000000000001
100000000000000000001
11111111111111111111