NO ./textures/north.xpm
SO ./textures/south.xpm
WE ./textures/west.xpm
EA ./textures/east.xpm
F 30,30,30
C 100,100,100

111111111111111111111
1N0000000001110000001
10000000000000000001
100000000000000000001
111111111111111111111