NO ./textures/north.xpm
SO ./textures/south.xpm
WE ./textures/west.xpm
EA ./textures/east.xpm
F 30,30,30
C 100,100,100

11111111111111111111
1N0000000001110000001
111111110001000011101
100000010001011000001
101110010001011111101
100010010000010000001
101110011111010111101
100000000001010000001
111111111101011111101
100000000001000000001
101111111111111111101
100000000000000000001
101111111111111111101
100000000000000000001
101111111111111111101
100000000000000000001
101111111111111111101
100000000000000000001
100000000000000000001
11111111111111111111