NO ./textures/north.xpm
SO ./textures/south.xpm
WE ./textures/west.xpm
EA ./textures/east.xpm
F 100,100,100
C 200,200,200

11111111111111111111
1N000011000011000001
11110111010101011111
10000100000100000001
10111101111101111101
10100001000001000001
10101111111111111101
10101000000000000101
10111011111111110101
10000010000000010101
11111110101111110101
10000000100000000101
10111110111111110101
10100000100000000101
10101111110111111101
10000000000100000001
11111111110101111111
10000000000100000001
10111111111111111111
11111111111111111111