NO ./textures/north.xpm
SO ./textures/south.xpm
WE ./textures/west.xpm
EA ./textures/east.xpm
F 80,80,80
C 180,180,180

11111111111111111111
1N0000000000000000001
11111111111111111001
10000000000000000001
10111111111111111111
10000000000000000001
11111111111111111001
10000000000000000001
10111111111111111111
10000000000000000001
11111111111111111001
10000000000000000001
10111111111111111111
10000000000000000001
11111111111111111001
10000000000000000001
11111111111111111111
10000000000000000001
10000000000000000001
11111111111111111111